10
2 10
0 -2 -8 9 -4 1 -5 7 -10 0 
9 -7 9 0 9 1 -2 4 -1 0 
3 5
0 6 -8 0 -6 
-2 2 2 -4 -1 
-1 0 -5 -2 0 
3 7
0 -6 -1 6 -1 -4 -1 
-7 -8 2 -8 -5 -8 1 
-9 6 -7 -3 -6 8 0 
8 8
0 -3 5 -7 5 0 -5 4 
6 -10 3 -10 7 8 6 0 
7 -9 -4 -5 -1 7 6 7 
1 -3 8 -3 -4 5 -4 -3 
7 0 6 -8 -8 -9 9 1 
-1 -9 9 -2 -5 -4 -2 -10 
-4 -9 -6 1 2 1 -9 3 
-3 -4 3 -8 9 -8 -4 0 
10 3
0 2 6 
4 2 -6 
4 -6 0 
-4 -8 -1 
4 3 -1 
-9 -6 -3 
-8 -9 0 
7 5 9 
-4 -7 -8 
2 -2 0 
4 3
0 3 7 
-1 8 -9 
6 8 0 
-10 2 0 
9 10
0 7 -6 -3 -9 7 -7 -5 6 -7 
-2 2 -8 0 2 2 -10 -3 3 -9 
8 2 -6 -4 -8 7 -2 4 7 -8 
-5 -3 2 -4 -7 7 -8 0 -10 7 
4 -1 5 1 2 5 -4 -2 -5 1 
4 -6 9 3 -4 9 -5 -3 -4 -8 
-8 -6 3 3 -3 9 -5 8 -2 -1 
-1 6 6 -1 8 0 -10 -3 4 -4 
-6 5 5 -1 -3 1 6 5 -6 0 
7 6
0 -10 -7 6 7 6 
0 4 -9 -9 4 -6 
4 -2 9 -5 -5 -4 
-5 7 4 1 4 -4 
0 9 -8 5 -2 -4 
4 -2 -4 -2 -10 -9 
-1 7 -4 -9 -5 0 
9 5
0 3 -5 0 1 
3 7 -8 -7 -10 
3 -9 -4 -3 -2 
-7 6 -7 -7 -4 
-5 -2 4 -1 6 
9 7 -8 -5 6 
-2 -8 -5 -6 6 
6 -2 -7 2 -5 
-8 -1 0 5 0 
6 7
0 3 1 -4 3 3 0 
1 4 0 -5 -7 1 -5 
-6 -1 -2 -8 7 6 0 
-1 -10 -10 -4 -10 -4 5 
5 9 -1 3 9 5 2 
-1 6 -8 -6 -5 -5 0