10
11 16
0 7 15 34 -25 -88 35 54 -41 -51 76 -48 56 43 5 -55 
-64 92 77 41 64 85 -12 -25 -14 10 2 32 -14 -79 28 -42 
-39 -92 -23 45 -62 -69 -36 27 -65 33 -78 -73 91 -58 -41 59 
22 53 -12 -20 -20 70 -61 -86 -25 -65 70 19 -42 -41 85 76 
30 -93 31 -37 -40 -60 91 -65 -37 -7 79 89 -12 73 -87 -33 
59 43 75 6 -73 -70 -44 -89 85 19 -59 6 93 17 18 55 
-35 -85 -38 -70 74 99 64 -79 -28 -61 75 70 -70 68 -78 50 
22 -41 -60 -28 34 -41 63 -17 34 6 15 24 -76 55 -22 94 
46 -20 -78 10 7 81 19 -31 97 -88 45 31 -99 -57 35 -33 
31 63 85 25 27 -90 -60 50 -15 -97 92 -6 -19 -23 71 -94 
-30 13 -33 60 -16 76 11 72 90 -79 -10 -44 -91 -38 -83 0 
14 17
0 -38 92 -89 -14 8 7 -16 44 27 -49 7 55 42 40 -40 25 
-72 19 -43 17 62 48 4 -82 84 91 5 -18 -71 -99 -57 59 -54 
13 -21 -14 23 86 56 -89 60 -45 49 -61 -41 -96 28 55 -83 -38 
45 -2 10 42 67 5 80 46 -64 -98 -41 -7 6 -89 -9 -35 72 
12 10 -83 55 4 85 -97 23 -46 24 58 -70 58 -12 -83 74 -64 
-35 24 -20 -5 0 -33 -69 71 -10 -4 -37 27 -63 83 -96 88 -17 
-91 86 4 85 37 66 54 78 -25 -32 -62 28 -46 -66 63 46 -77 
81 -64 -14 76 87 64 13 -43 37 97 17 -94 2 -74 -2 12 51 
-73 37 61 -72 -27 32 70 -49 31 46 3 24 5 -50 -86 -95 -85 
-23 55 10 -24 -3 -36 83 -57 -17 23 5 -43 25 -44 -81 61 36 
-99 -22 -64 -25 7 -81 -55 73 55 -41 32 76 -83 19 53 67 -16 
-74 -40 -83 -14 -41 -10 82 92 75 -33 -3 85 90 61 -61 87 65 
-81 35 27 8 -41 70 31 -59 41 1 93 57 -26 -95 -35 9 -48 
54 -67 16 -98 -85 65 51 90 -35 -18 -3 -79 57 3 20 -14 0 
6 12
0 -83 -22 17 -88 77 -79 18 6 34 -64 -51 
7 32 0 -90 47 -23 -84 21 -50 14 79 6 
-97 63 63 -78 -15 24 -6 -66 51 -83 72 19 
45 -41 17 -66 -52 -81 25 16 -97 -22 -16 89 
24 85 55 25 61 -61 -48 47 40 -83 45 5 
-13 -55 -20 -93 32 -97 50 -77 -40 -57 -51 0 
19 11
0 -100 -66 -68 -97 73 43 78 49 15 -82 
-94 -78 -18 68 -30 20 44 -87 -97 89 8 
58 58 78 -39 96 39 -42 15 -34 35 9 
-96 85 -97 -20 78 -58 -75 -37 63 -32 59 
-12 -91 58 63 53 -66 -93 -71 -79 7 -80 
-73 -49 -59 14 -44 35 -28 -15 18 -63 44 
-44 -21 -48 -80 2 -54 51 -15 52 79 -42 
-45 -12 -5 71 85 -71 -72 -86 -1 84 45 
-78 -9 -6 81 -91 -35 3 -43 79 24 3 
15 33 48 39 20 35 -51 -78 -74 24 -89 
32 -10 98 24 -69 -20 -42 48 -52 37 41 
-49 36 -92 26 -80 -69 -60 -62 92 2 -52 
49 4 68 52 -5 -61 90 -73 83 -61 -25 
-70 15 23 -56 -28 84 -15 17 -82 -45 14 
-44 37 -60 94 -13 6 10 48 80 81 40 
5 -53 -31 74 20 83 -77 14 62 33 -83 
68 74 26 97 69 4 -69 -39 0 18 -71 
45 -13 48 89 -76 23 -28 -82 -1 52 28 
98 -44 40 6 -81 89 -94 -64 61 47 0 
20 4
0 0 0 -71 
-2 81 20 13 
12 77 68 94 
-51 -70 -72 52 
54 79 47 50 
-44 93 26 -36 
-86 94 -47 85 
73 4 -99 -24 
24 45 -35 61 
-20 -75 -43 86 
-39 -100 -20 -6 
-70 -22 -4 2 
-91 -71 8 67 
34 -6 -39 75 
-10 -78 65 63 
3 -50 68 20 
50 12 59 -27 
-12 -12 -85 -19 
-43 -40 -34 85 
-30 48 -95 0 
7 7
0 -52 -18 94 -63 60 84 
-18 -40 28 -60 -39 71 -51 
-7 94 -94 -14 21 -9 64 
-86 -97 31 84 -34 -98 -94 
61 -99 69 -98 -16 -1 79 
-55 -68 79 36 75 -10 44 
-27 53 -25 49 -20 90 0 
14 18
0 -45 -76 -24 43 85 71 -59 -78 -39 90 69 -5 -88 58 29 92 -95 
-53 63 48 76 -17 -51 43 66 -71 -84 -23 -52 35 -68 94 -13 68 63 
27 -48 6 0 56 46 -89 23 77 -60 70 -70 38 95 97 53 94 32 
85 77 -62 10 -19 49 -87 54 -10 66 -93 -22 59 -43 -32 71 12 47 
98 -30 -84 65 46 6 -53 99 -81 96 -47 -99 -21 43 -75 -84 74 21 
85 -6 68 34 -82 42 -85 -41 -41 -78 -79 -79 1 -63 -70 -89 -87 -69 
-59 13 -95 -53 95 11 -13 80 -47 -10 16 -45 84 -3 41 80 -14 38 
-44 -53 -90 42 -16 -99 -42 86 84 55 -32 20 -75 70 -85 -71 63 8 
-9 96 -41 -34 -24 87 -58 -94 -73 -15 0 -62 -7 52 69 30 -20 91 
40 -25 -72 46 -17 72 82 -64 2 -30 -1 -78 79 -62 -42 23 -52 -59 
-18 80 87 0 -77 -56 3 -55 -77 26 68 90 -26 18 -51 31 21 -55 
16 85 42 45 -26 22 33 -8 -57 -46 -91 -24 -76 -64 -43 -17 75 -3 
88 -44 42 12 -40 10 64 24 3 -17 89 -2 -57 31 40 -50 -57 50 
-6 -38 -95 -28 16 96 19 -77 69 13 93 38 -71 -85 -65 44 29 0 
5 17
0 15 4 -38 -46 -53 46 -55 -17 42 -54 -65 -34 -64 -88 -76 66 
91 88 -16 -8 -19 28 -76 -22 -9 -32 -48 -4 97 95 -68 -35 72 
-57 -53 -39 55 -47 -35 -60 -71 34 -68 17 -11 -3 -55 92 27 -84 
24 85 -49 44 49 54 92 -15 -64 94 -54 -54 31 7 26 -81 -53 
77 -63 72 -36 -87 -60 23 25 -44 -20 80 99 0 50 -72 25 0 
8 19
0 -75 -64 84 -28 29 56 40 91 -82 -98 49 -16 96 -78 19 -81 36 -45 
89 78 -48 -93 -70 -85 -68 94 43 -84 -84 -37 -51 -56 63 35 -48 -20 23 
-22 16 -40 58 -20 55 -5 88 -94 -77 -100 -50 -83 1 3 19 74 -46 15 
-71 -17 77 82 6 69 -74 -38 -61 94 -91 32 -43 -63 -46 78 -46 -5 48 
5 -82 96 -9 -19 63 -77 -74 64 29 26 8 97 -57 -66 7 -87 66 73 
-1 43 35 -63 68 17 94 -68 -82 -11 40 12 -100 -20 34 -27 7 32 87 
60 89 -26 40 51 93 -16 53 -46 -64 -77 56 -72 8 59 61 -85 68 -99 
84 36 13 -67 50 46 84 42 36 88 -100 -9 37 41 -88 -77 -37 -60 0 
11 8
0 32 38 -81 90 -94 -22 2 
68 14 37 -3 96 22 -50 24 
10 -41 -43 -53 -94 13 25 35 
-30 13 57 93 62 -55 -4 -11 
-84 88 68 89 -42 -44 -64 -23 
30 32 26 58 33 74 -87 36 
-65 53 -57 73 27 -38 -99 31 
38 -32 -2 47 24 -63 34 62 
25 -41 4 -52 37 -33 -99 12 
55 52 82 11 -57 -57 92 -35 
78 -50 -1 76 -6 -53 -11 0