10
30 30 0 10000
XXXXXXXXXXXXXXXXXXXXXXXXXXXXXX
XXXXXXXXXXXXXXXXXXXXXXXXXXX...
.XXXXXXXXXXXXXXXX.......XXX.X.
.........XXXXXXXX.XXXXX.XXX.X.
...XXX.X.XXXXXXXX.XXXXX.XXX.X.
...XXX.X.XXXXXXXX.X...........
XX.XXX.X..........X.XXX.XXX.XX
XX.X.X.XXXXXXXXXXXX.XXX.XXX.XX
XX.X.X.XXXXXXXXXXXX.XXX.XXX.XX
XX.X...XXXXXXXXXXXX.XXX.XXX.XX
XX.XXXXXXXXXXXXXXXX.XXX.XXX.XX
XX.XXXXXXXXXXXXXXXX.XXX.XXX.XX
XX.XXXXXXXXXXXXXXXX.XXX.XXX.XX
XX.XXX..............XXX.XXX.XX
XX.XXX.XXXXXXXXXXXX.XXX.....XX
XX.XXX.XXXXXXXXXXXE.XXXXXXXXXX
XX.XXX.XXXXXXXXXXX.XXXXXXXXXXX
XX.XXX.XXXXXXXXXXX.XXXXXXXXXXX
XX.XXX.XXXXXXXXXXX.XXXXXXXXXXX
XX.XXX.X....XXXXXX.XXXXXXXXXXX
X........XX.XXXXXX.XXXXXXXXXXX
X.XXXXXX.XX.XXXXXX.XXXXXXXXXXX
X.XXXXXX.XX.XXXXXX.....XXXXXXX
X.XXXXXX.XX.XXXXXXXXXX.XXXXXXX
X.P...XX.XX.XXXXXXXXXX.XXXXXXX
XXXXX.XX.XX.XXXXXXXXXX.XXXXXXX
XXXXX.XX.XX.XXXXXXXXXX.XXXXXXX
XXXXX.XX.XX............XXXXXXX
XXXXX....XXXXXXXXXXXXXXXXXXXXX
XXXXXXXXXXXXXXXXXXXXXXXXXXXXXX
30 30 0 10000
XXXXXXXXXXXXXXXXXXXXXXXXXXXXXX
XXXXXXXXXXXXXXXXXXXXXXXXXXX...
.XXXXXXXXXXXXXXXX.......XXX.X.
.........XXXXXXXX.XXXXX.XXX.X.
...XXX.X.XXXXXXXX.XXXXX.XXX.X.
...XXX.X.XXXXXXXX.X...........
XX.XXX.X..........X.XXX.XXX.XX
XX.X.X.XXXXXXXXXXXX.XXX.XXX.XX
XX.X.X.XXXXXXXXXXXX.XXX.XXX.XX
XX.X...XXXXXXXXXXXX.XXX.XXX.XX
XX.XXXXXXXXXXXXXXXX.XXX.XXX.XX
XX.XXXXXXXXXXXXXXXX.XXX.XXX.XX
XX.XXXXXXXXXXXXXXXX.XXX.XXX.XX
XX.XXX..............XXX.XXX.XX
XX.XXX.XXXXXXXXXXXX.XXX.....XX
XX.XXX.XXXXXXXXXXXE.XXXXXXXXXX
XX.XXX.XXXXXXXXXXX.XXXXXXXXXXX
XX.XXX.XXXXXXXXXXX.XXXXXXXXXXX
XX.XXX.XXXXXXXXXXX.XXXXXXXXXXX
XX.XXX.X....XXXXXX.XXXXXXXXXXX
X........XX.XXXXXX.XXXXXXXXXXX
X.XXXXXX.XX.XXXXXX.XXXXXXXXXXX
X.XXXXXX.XX.XXXXXX.....XXXXXXX
X.XXXXXX.XX.XXXXXXXXXX.XXXXXXX
X.P...XX.XX.XXXXXXXXXX.XXXXXXX
XXXXX.XX.XX.XXXXXXXXXX.XXXXXXX
XXXXX.XX.XX.XXXXXXXXXX.XXXXXXX
XXXXX.XX.XX............XXXXXXX
XXXXX....XXXXXXXXXXXXXXXXXXXXX
XXXXXXXXXXXXXXXXXXXXXXXXXXXXXX
30 30 0 10000
XXXXXXXXXXXXXXXXXXXXXXXXXXXXXX
XXXXXXXXXXXXXXXXXXXXXXXXXXX...
.XXXXXXXXXXXXXXXX.......XXX.X.
.........XXXXXXXX.XXXXX.XXX.X.
...XXX.X.XXXXXXXX.XXXXX.XXX.X.
...XXX.X.XXXXXXXX.X...........
XX.XXX.X..........X.XXX.XXX.XX
XX.X.X.XXXXXXXXXXXX.XXX.XXX.XX
XX.X.X.XXXXXXXXXXXX.XXX.XXX.XX
XX.X...XXXXXXXXXXXX.XXX.XXX.XX
XX.XXXXXXXXXXXXXXXX.XXX.XXX.XX
XX.XXXXXXXXXXXXXXXX.XXX.XXX.XX
XX.XXXXXXXXXXXXXXXX.XXX.XXX.XX
XX.XXX..............XXX.XXX.XX
XX.XXX.XXXXXXXXXXXX.XXX.....XX
XX.XXX.XXXXXXXXXXXE.XXXXXXXXXX
XX.XXX.XXXXXXXXXXX.XXXXXXXXXXX
XX.XXX.XXXXXXXXXXX.XXXXXXXXXXX
XX.XXX.XXXXXXXXXXX.XXXXXXXXXXX
XX.XXX.X....XXXXXX.XXXXXXXXXXX
X........XX.XXXXXX.XXXXXXXXXXX
X.XXXXXX.XX.XXXXXX.XXXXXXXXXXX
X.XXXXXX.XX.XXXXXX.....XXXXXXX
X.XXXXXX.XX.XXXXXXXXXX.XXXXXXX
X.P...XX.XX.XXXXXXXXXX.XXXXXXX
XXXXX.XX.XX.XXXXXXXXXX.XXXXXXX
XXXXX.XX.XX.XXXXXXXXXX.XXXXXXX
XXXXX.XX.XX............XXXXXXX
XXXXX....XXXXXXXXXXXXXXXXXXXXX
XXXXXXXXXXXXXXXXXXXXXXXXXXXXXX
30 30 0 10000
XXXXXXXXXXXXXXXXXXXXXXXXXXXXXX
XXXXXXXXXXXXXXXXXXXXXXXXXXX...
.XXXXXXXXXXXXXXXX.......XXX.X.
.........XXXXXXXX.XXXXX.XXX.X.
...XXX.X.XXXXXXXX.XXXXX.XXX.X.
...XXX.X.XXXXXXXX.X...........
XX.XXX.X..........X.XXX.XXX.XX
XX.X.X.XXXXXXXXXXXX.XXX.XXX.XX
XX.X.X.XXXXXXXXXXXX.XXX.XXX.XX
XX.X...XXXXXXXXXXXX.XXX.XXX.XX
XX.XXXXXXXXXXXXXXXX.XXX.XXX.XX
XX.XXXXXXXXXXXXXXXX.XXX.XXX.XX
XX.XXXXXXXXXXXXXXXX.XXX.XXX.XX
XX.XXX..............XXX.XXX.XX
XX.XXX.XXXXXXXXXXXX.XXX.....XX
XX.XXX.XXXXXXXXXXXE.XXXXXXXXXX
XX.XXX.XXXXXXXXXXX.XXXXXXXXXXX
XX.XXX.XXXXXXXXXXX.XXXXXXXXXXX
XX.XXX.XXXXXXXXXXX.XXXXXXXXXXX
XX.XXX.X....XXXXXX.XXXXXXXXXXX
X........XX.XXXXXX.XXXXXXXXXXX
X.XXXXXX.XX.XXXXXX.XXXXXXXXXXX
X.XXXXXX.XX.XXXXXX.....XXXXXXX
X.XXXXXX.XX.XXXXXXXXXX.XXXXXXX
X.P...XX.XX.XXXXXXXXXX.XXXXXXX
XXXXX.XX.XX.XXXXXXXXXX.XXXXXXX
XXXXX.XX.XX.XXXXXXXXXX.XXXXXXX
XXXXX.XX.XX............XXXXXXX
XXXXX....XXXXXXXXXXXXXXXXXXXXX
XXXXXXXXXXXXXXXXXXXXXXXXXXXXXX
30 30 0 10000
XXXXXXXXXXXXXXXXXXXXXXXXXXXXXX
XXXXXXXXXXXXXXXXXXXXXXXXXXX...
.XXXXXXXXXXXXXXXX.......XXX.X.
.........XXXXXXXX.XXXXX.XXX.X.
...XXX.X.XXXXXXXX.XXXXX.XXX.X.
...XXX.X.XXXXXXXX.X...........
XX.XXX.X..........X.XXX.XXX.XX
XX.X.X.XXXXXXXXXXXX.XXX.XXX.XX
XX.X.X.XXXXXXXXXXXX.XXX.XXX.XX
XX.X...XXXXXXXXXXXX.XXX.XXX.XX
XX.XXXXXXXXXXXXXXXX.XXX.XXX.XX
XX.XXXXXXXXXXXXXXXX.XXX.XXX.XX
XX.XXXXXXXXXXXXXXXX.XXX.XXX.XX
XX.XXX..............XXX.XXX.XX
XX.XXX.XXXXXXXXXXXX.XXX.....XX
XX.XXX.XXXXXXXXXXXE.XXXXXXXXXX
XX.XXX.XXXXXXXXXXX.XXXXXXXXXXX
XX.XXX.XXXXXXXXXXX.XXXXXXXXXXX
XX.XXX.XXXXXXXXXXX.XXXXXXXXXXX
XX.XXX.X....XXXXXX.XXXXXXXXXXX
X........XX.XXXXXX.XXXXXXXXXXX
X.XXXXXX.XX.XXXXXX.XXXXXXXXXXX
X.XXXXXX.XX.XXXXXX.....XXXXXXX
X.XXXXXX.XX.XXXXXXXXXX.XXXXXXX
X.P...XX.XX.XXXXXXXXXX.XXXXXXX
XXXXX.XX.XX.XXXXXXXXXX.XXXXXXX
XXXXX.XX.XX.XXXXXXXXXX.XXXXXXX
XXXXX.XX.XX............XXXXXXX
XXXXX....XXXXXXXXXXXXXXXXXXXXX
XXXXXXXXXXXXXXXXXXXXXXXXXXXXXX
30 30 0 10000
XXXXXXXXXXXXXXXXXXXXXXXXXXXXXX
XXXXXXXXXXXXXXXXXXXXXXXXXXX...
.XXXXXXXXXXXXXXXX.......XXX.X.
.........XXXXXXXX.XXXXX.XXX.X.
...XXX.X.XXXXXXXX.XXXXX.XXX.X.
...XXX.X.XXXXXXXX.X...........
XX.XXX.X..........X.XXX.XXX.XX
XX.X.X.XXXXXXXXXXXX.XXX.XXX.XX
XX.X.X.XXXXXXXXXXXX.XXX.XXX.XX
XX.X...XXXXXXXXXXXX.XXX.XXX.XX
XX.XXXXXXXXXXXXXXXX.XXX.XXX.XX
XX.XXXXXXXXXXXXXXXX.XXX.XXX.XX
XX.XXXXXXXXXXXXXXXX.XXX.XXX.XX
XX.XXX..............XXX.XXX.XX
XX.XXX.XXXXXXXXXXXX.XXX.....XX
XX.XXX.XXXXXXXXXXXE.XXXXXXXXXX
XX.XXX.XXXXXXXXXXX.XXXXXXXXXXX
XX.XXX.XXXXXXXXXXX.XXXXXXXXXXX
XX.XXX.XXXXXXXXXXX.XXXXXXXXXXX
XX.XXX.X....XXXXXX.XXXXXXXXXXX
X........XX.XXXXXX.XXXXXXXXXXX
X.XXXXXX.XX.XXXXXX.XXXXXXXXXXX
X.XXXXXX.XX.XXXXXX.....XXXXXXX
X.XXXXXX.XX.XXXXXXXXXX.XXXXXXX
X.P...XX.XX.XXXXXXXXXX.XXXXXXX
XXXXX.XX.XX.XXXXXXXXXX.XXXXXXX
XXXXX.XX.XX.XXXXXXXXXX.XXXXXXX
XXXXX.XX.XX............XXXXXXX
XXXXX....XXXXXXXXXXXXXXXXXXXXX
XXXXXXXXXXXXXXXXXXXXXXXXXXXXXX
30 30 0 10000
XXXXXXXXXXXXXXXXXXXXXXXXXXXXXX
XXXXXXXXXXXXXXXXXXXXXXXXXXX...
.XXXXXXXXXXXXXXXX.......XXX.X.
.........XXXXXXXX.XXXXX.XXX.X.
...XXX.X.XXXXXXXX.XXXXX.XXX.X.
...XXX.X.XXXXXXXX.X...........
XX.XXX.X..........X.XXX.XXX.XX
XX.X.X.XXXXXXXXXXXX.XXX.XXX.XX
XX.X.X.XXXXXXXXXXXX.XXX.XXX.XX
XX.X...XXXXXXXXXXXX.XXX.XXX.XX
XX.XXXXXXXXXXXXXXXX.XXX.XXX.XX
XX.XXXXXXXXXXXXXXXX.XXX.XXX.XX
XX.XXXXXXXXXXXXXXXX.XXX.XXX.XX
XX.XXX..............XXX.XXX.XX
XX.XXX.XXXXXXXXXXXX.XXX.....XX
XX.XXX.XXXXXXXXXXXE.XXXXXXXXXX
XX.XXX.XXXXXXXXXXX.XXXXXXXXXXX
XX.XXX.XXXXXXXXXXX.XXXXXXXXXXX
XX.XXX.XXXXXXXXXXX.XXXXXXXXXXX
XX.XXX.X....XXXXXX.XXXXXXXXXXX
X........XX.XXXXXX.XXXXXXXXXXX
X.XXXXXX.XX.XXXXXX.XXXXXXXXXXX
X.XXXXXX.XX.XXXXXX.....XXXXXXX
X.XXXXXX.XX.XXXXXXXXXX.XXXXXXX
X.P...XX.XX.XXXXXXXXXX.XXXXXXX
XXXXX.XX.XX.XXXXXXXXXX.XXXXXXX
XXXXX.XX.XX.XXXXXXXXXX.XXXXXXX
XXXXX.XX.XX............XXXXXXX
XXXXX....XXXXXXXXXXXXXXXXXXXXX
XXXXXXXXXXXXXXXXXXXXXXXXXXXXXX
30 30 0 10000
XXXXXXXXXXXXXXXXXXXXXXXXXXXXXX
XXXXXXXXXXXXXXXXXXXXXXXXXXX...
.XXXXXXXXXXXXXXXX.......XXX.X.
.........XXXXXXXX.XXXXX.XXX.X.
...XXX.X.XXXXXXXX.XXXXX.XXX.X.
...XXX.X.XXXXXXXX.X...........
XX.XXX.X..........X.XXX.XXX.XX
XX.X.X.XXXXXXXXXXXX.XXX.XXX.XX
XX.X.X.XXXXXXXXXXXX.XXX.XXX.XX
XX.X...XXXXXXXXXXXX.XXX.XXX.XX
XX.XXXXXXXXXXXXXXXX.XXX.XXX.XX
XX.XXXXXXXXXXXXXXXX.XXX.XXX.XX
XX.XXXXXXXXXXXXXXXX.XXX.XXX.XX
XX.XXX..............XXX.XXX.XX
XX.XXX.XXXXXXXXXXXX.XXX.....XX
XX.XXX.XXXXXXXXXXXE.XXXXXXXXXX
XX.XXX.XXXXXXXXXXX.XXXXXXXXXXX
XX.XXX.XXXXXXXXXXX.XXXXXXXXXXX
XX.XXX.XXXXXXXXXXX.XXXXXXXXXXX
XX.XXX.X....XXXXXX.XXXXXXXXXXX
X........XX.XXXXXX.XXXXXXXXXXX
X.XXXXXX.XX.XXXXXX.XXXXXXXXXXX
X.XXXXXX.XX.XXXXXX.....XXXXXXX
X.XXXXXX.XX.XXXXXXXXXX.XXXXXXX
X.P...XX.XX.XXXXXXXXXX.XXXXXXX
XXXXX.XX.XX.XXXXXXXXXX.XXXXXXX
XXXXX.XX.XX.XXXXXXXXXX.XXXXXXX
XXXXX.XX.XX............XXXXXXX
XXXXX....XXXXXXXXXXXXXXXXXXXXX
XXXXXXXXXXXXXXXXXXXXXXXXXXXXXX
30 30 0 10000
XXXXXXXXXXXXXXXXXXXXXXXXXXXXXX
XXXXXXXXXXXXXXXXXXXXXXXXXXX...
.XXXXXXXXXXXXXXXX.......XXX.X.
.........XXXXXXXX.XXXXX.XXX.X.
...XXX.X.XXXXXXXX.XXXXX.XXX.X.
...XXX.X.XXXXXXXX.X...........
XX.XXX.X..........X.XXX.XXX.XX
XX.X.X.XXXXXXXXXXXX.XXX.XXX.XX
XX.X.X.XXXXXXXXXXXX.XXX.XXX.XX
XX.X...XXXXXXXXXXXX.XXX.XXX.XX
XX.XXXXXXXXXXXXXXXX.XXX.XXX.XX
XX.XXXXXXXXXXXXXXXX.XXX.XXX.XX
XX.XXXXXXXXXXXXXXXX.XXX.XXX.XX
XX.XXX..............XXX.XXX.XX
XX.XXX.XXXXXXXXXXXX.XXX.....XX
XX.XXX.XXXXXXXXXXXE.XXXXXXXXXX
XX.XXX.XXXXXXXXXXX.XXXXXXXXXXX
XX.XXX.XXXXXXXXXXX.XXXXXXXXXXX
XX.XXX.XXXXXXXXXXX.XXXXXXXXXXX
XX.XXX.X....XXXXXX.XXXXXXXXXXX
X........XX.XXXXXX.XXXXXXXXXXX
X.XXXXXX.XX.XXXXXX.XXXXXXXXXXX
X.XXXXXX.XX.XXXXXX.....XXXXXXX
X.XXXXXX.XX.XXXXXXXXXX.XXXXXXX
X.P...XX.XX.XXXXXXXXXX.XXXXXXX
XXXXX.XX.XX.XXXXXXXXXX.XXXXXXX
XXXXX.XX.XX.XXXXXXXXXX.XXXXXXX
XXXXX.XX.XX............XXXXXXX
XXXXX....XXXXXXXXXXXXXXXXXXXXX
XXXXXXXXXXXXXXXXXXXXXXXXXXXXXX
30 30 0 10000
XXXXXXXXXXXXXXXXXXXXXXXXXXXXXX
XXXXXXXXXXXXXXXXXXXXXXXXXXX...
.XXXXXXXXXXXXXXXX.......XXX.X.
.........XXXXXXXX.XXXXX.XXX.X.
...XXX.X.XXXXXXXX.XXXXX.XXX.X.
...XXX.X.XXXXXXXX.X...........
XX.XXX.X..........X.XXX.XXX.XX
XX.X.X.XXXXXXXXXXXX.XXX.XXX.XX
XX.X.X.XXXXXXXXXXXX.XXX.XXX.XX
XX.X...XXXXXXXXXXXX.XXX.XXX.XX
XX.XXXXXXXXXXXXXXXX.XXX.XXX.XX
XX.XXXXXXXXXXXXXXXX.XXX.XXX.XX
XX.XXXXXXXXXXXXXXXX.XXX.XXX.XX
XX.XXX..............XXX.XXX.XX
XX.XXX.XXXXXXXXXXXX.XXX.....XX
XX.XXX.XXXXXXXXXXXE.XXXXXXXXXX
XX.XXX.XXXXXXXXXXX.XXXXXXXXXXX
XX.XXX.XXXXXXXXXXX.XXXXXXXXXXX
XX.XXX.XXXXXXXXXXX.XXXXXXXXXXX
XX.XXX.X....XXXXXX.XXXXXXXXXXX
X........XX.XXXXXX.XXXXXXXXXXX
X.XXXXXX.XX.XXXXXX.XXXXXXXXXXX
X.XXXXXX.XX.XXXXXX.....XXXXXXX
X.XXXXXX.XX.XXXXXXXXXX.XXXXXXX
X.P...XX.XX.XXXXXXXXXX.XXXXXXX
XXXXX.XX.XX.XXXXXXXXXX.XXXXXXX
XXXXX.XX.XX.XXXXXXXXXX.XXXXXXX
XXXXX.XX.XX............XXXXXXX
XXXXX....XXXXXXXXXXXXXXXXXXXXX
XXXXXXXXXXXXXXXXXXXXXXXXXXXXXX