7
2 2500
0 2500
2500 0
2 2501
0 2500
2500 0
3 1
0 1 0
0 0 0
0 0 0
3 2
0 0 0
0 0 1
0 0 0
3 0
0 0 0
0 0 0
0 0 0
3 3
0 1 1
1 1 1
1 1 0
10 0
0 0 0 0 1 0 0 0 0 0
0 0 0 0 2 0 0 0 0 0
0 0 0 0 3 0 0 0 0 0
0 0 0 0 0 0 4 5 0 0
0 0 0 0 0 0 0 6 0 0
0 0 0 0 0 0 0 0 0 0
0 0 0 0 0 0 0 7 0 0
0 0 0 0 0 0 0 0 8 0
0 0 0 0 0 0 0 0 9 0
0 0 0 0 0 0 0 0 10 0
