18
11
11 9 4 1 4 5 7 3 6 7 9 8 
3 1 8 7 
6 1 8 3 10 8 9 
5 3 9 7 5 10 
6 9 4 4 2 4 6 
4 8 6 2 5 
3 9 6 4 
3 1 5 8 
1 9 
10 8 6 8 8 4 9 6 10 7 10 
11 3 2 6 2 3 1 7 9 7 2 4 
18
14 8 7 6 3 5 6 10 10 7 7 5 9 2 4 
12 9 10 7 3 1 2 5 2 8 10 3 10 
5 10 3 3 1 5 
15 1 3 3 1 3 1 4 5 10 8 2 8 2 1 4 
14 9 2 1 6 1 10 3 10 3 3 5 6 8 1 
9 2 4 4 9 4 5 6 4 1 
13 9 5 8 6 2 10 9 9 6 5 2 5 5 
2 8 9 
14 6 9 6 7 5 4 7 5 6 8 7 10 6 8 
13 1 4 7 3 3 9 9 3 6 3 4 6 4 
12 10 4 4 7 1 6 9 1 6 10 4 8 
3 3 2 1 
12 7 7 10 6 3 8 6 4 9 8 2 6 
5 3 9 7 10 8 
3 9 10 2 
4 9 1 9 4 
3 1 7 4 
8 4 9 7 5 2 5 5 9 
19
11 9 8 5 6 8 5 1 8 10 7 2 
14 7 6 1 2 8 9 7 2 5 7 10 1 8 10 
11 9 7 1 10 9 7 1 5 6 1 7 
11 1 10 10 7 8 4 9 2 4 7 6 
14 4 7 3 1 7 7 6 6 10 1 7 2 7 6 
10 6 7 2 2 4 5 7 9 10 9 
13 8 5 4 3 1 4 10 8 3 9 6 7 6 
11 10 2 9 7 2 3 2 5 7 4 6 
6 8 10 2 1 1 8 
10 9 4 1 5 8 7 4 6 3 6 
10 1 1 4 5 3 9 1 4 5 8 
4 7 7 10 1 
13 7 1 6 8 2 8 2 2 9 8 3 4 2 
7 9 5 5 10 2 9 7 
15 6 10 3 8 1 1 6 4 2 10 7 10 4 7 5 
5 2 8 5 8 10 
10 8 6 10 3 8 5 10 3 7 2 
4 3 4 4 5 
4 9 8 9 7 
17
5 7 4 6 6 7 
8 3 7 1 9 8 2 2 2 
1 2 
1 5 
3 7 3 10 
5 2 10 9 6 7 
14 7 4 7 2 6 5 7 7 2 8 1 9 10 7 
9 1 10 3 3 9 6 6 10 5 
4 5 2 1 6 
13 8 6 2 7 7 8 4 4 5 8 7 7 5 
11 7 4 8 3 4 5 6 7 5 7 9 
11 7 7 2 10 9 9 4 6 4 4 6 
6 1 8 7 5 3 5 
5 9 2 5 2 1 
2 6 1 
13 1 5 7 5 2 4 10 5 3 8 6 3 3 
13 6 5 8 10 5 6 3 6 10 9 6 3 9 
15
15 10 8 7 1 8 8 4 1 4 7 4 3 7 2 10 
5 3 6 4 3 9 
14 6 8 5 10 5 5 6 1 7 10 3 8 10 4 
4 9 8 1 4 
14 5 5 9 4 8 9 7 10 9 5 7 9 7 8 
6 6 5 7 9 1 7 
3 6 3 2 
6 2 6 3 4 1 2 
12 8 7 3 6 3 5 9 4 5 4 3 3 
3 6 10 3 
11 7 10 8 2 2 7 3 3 9 2 8 
12 2 8 3 8 5 7 9 8 10 2 5 4 
10 7 3 10 5 8 5 10 4 2 9 
10 4 10 6 1 4 1 9 7 7 7 
1 5 
3
2 8 7 
12 2 1 5 1 1 9 7 4 6 8 2 1 
6 8 6 2 6 1 9 
6
15 8 1 2 7 9 8 5 6 7 5 4 2 7 5 9 
12 4 9 4 4 7 9 5 5 3 4 8 7 
15 6 9 9 2 4 2 6 2 8 9 9 6 9 2 10 
11 7 1 8 2 7 6 6 2 4 10 10 
15 7 3 3 6 7 1 9 1 2 6 6 6 2 1 9 
15 8 4 6 7 6 9 4 1 8 6 8 9 9 1 2 
8
4 4 6 10 9 
7 10 5 6 7 5 10 9 
13 6 2 7 8 6 6 9 1 5 2 3 2 1 
13 9 1 3 6 2 5 3 6 3 8 6 3 10 
12 4 2 7 3 5 7 7 1 5 8 6 3 
10 1 7 9 7 8 7 8 4 4 4 
11 4 8 8 4 1 5 5 7 7 8 6 
10 10 7 8 6 7 7 10 7 10 3 
7
6 4 6 8 9 9 2 
5 3 1 5 1 6 
13 2 3 4 10 5 5 8 10 8 9 7 2 9 
1 9 
13 8 6 4 8 10 9 9 2 6 2 9 2 7 
6 5 9 8 3 4 3 
5 8 3 1 4 6 
2
10 9 5 3 4 4 2 6 7 6 6 
15 9 8 4 4 5 4 2 7 8 9 4 1 4 10 6 
15
13 1 9 4 9 6 2 1 2 6 4 4 3 6 
11 4 2 7 7 7 4 10 1 2 4 10 
12 6 5 2 10 10 6 5 3 4 5 6 9 
11 5 4 1 2 6 7 7 10 5 6 8 
14 3 2 9 3 8 3 6 10 6 2 4 6 3 10 
5 7 1 7 5 1 
1 10 
13 9 10 3 10 3 6 5 7 10 5 4 5 1 
12 7 2 5 6 3 4 10 8 1 9 3 3 
5 10 9 5 8 8 
8 2 7 9 8 3 4 8 10 
8 8 6 7 6 8 5 3 5 
4 5 5 3 5 
12 4 8 9 5 6 8 7 10 9 6 5 1 
5 3 4 4 2 7 
4
3 6 4 6 
14 8 4 2 9 7 4 2 4 6 5 6 4 8 9 
12 5 1 9 7 3 4 2 9 4 5 8 8 
10 6 6 8 5 8 9 6 5 3 2 
4
5 3 4 7 8 2 
11 7 6 1 6 4 6 5 5 9 4 5 
1 3 
5 9 4 2 10 6 
7
6 10 10 1 2 8 9 
9 7 10 9 10 6 7 6 1 6 
12 8 5 7 8 1 9 6 9 6 9 6 1 
13 1 1 10 10 3 10 5 4 10 1 7 9 9 
6 7 2 4 4 4 3 
5 5 5 6 8 6 
8 6 3 3 9 5 3 3 7 
10
6 10 10 4 7 2 10 
14 2 7 4 5 4 4 2 6 2 8 3 6 9 9 
1 6 
8 7 8 2 10 10 7 3 6 
2 4 7 
8 5 7 4 10 7 2 2 8 
6 10 7 10 10 7 8 
1 3 
9 10 8 2 9 10 4 2 10 3 
2 1 2 
2
2 200 1
3 1 100 2
2
3 1 1000 2
3 2 1 1
4
3 1 5 100
3 1 5 100
3 100 1 1
3 100 1 1