30
4 10
1101000101
0110101010
0010010010
1110011011
4 10
0010001111
0000111001
0100010111
0100111111
4 10
1011011100
1001101010
0001111010
1000100111
4 10
0101011000
0101001011
1100001101
1111001000
4 10
1101011010
1110110101
1010001100
1101100111
4 10
1001011110
0010100110
1101100110
0100001110
4 10
1111001110
0001000011
0010011100
0001110000
4 10
1101111001
1110000101
0111011011
1101000100
4 10
0101010111
1110100000
0111011000
1011000011
4 10
0010000111
0110100000
1010010100
0100101001
4 10
1010111011
1110010111
0101111110
1001100001
4 10
1011101010
0111000101
0011100011
0100100111
4 10
1110011111
0000101011
0101001101
0111000000
4 10
1100011011
1000001100
1011111101
1110011010
4 10
1100010001
0110111010
0011100001
1110001101
4 10
1111110001
0100010011
0111111010
0001000000
4 10
1010101000
1011100110
1100000011
1110011000
4 10
1110100111
0001011100
1000101001
1010001110
4 10
0101100111
0010010011
0111100101
1100010110
4 10
0100010110
1111101110
0011101000
0000110111
4 10
1001110111
0100010000
1011011100
0111010110
4 10
1101011111
1110001111
1010000010
1000110010
4 10
1111011100
1011111110
1100110111
0101110111
4 10
0100111011
0010011011
0010111001
1010010101
4 10
0011101010
0100001101
0001100001
1110101001
4 10
1001001100
0000011100
0001101010
1000100000
4 10
0101001011
1100011000
0001000111
1110001101
4 10
0011010101
0000011001
1011100101
0101111101
4 10
0000000000
0000000000
0000000000
0000000000
4 10
1111111111
1111111111
1111111111
1111111111
