30
10 25
1111111011011111010001111
1100100011101000011100001
0001011011001010001110111
0110101111010010111001100
1101001011110111101111001
1001001010001110111110101
1111011011110001011011001
1110101110010111110101011
0100001000100101111011100
0111101100010001100000010
10 25
1101100101000100111000111
0111111011000000001001100
0111010110111000100001110
1001011111111110111010000
0000110111000001101001010
0000001111000000001001110
0000011000110101010110101
1111010101110011111100000
0010001101000000101100001
1011001000101100010100011
10 25
1100001100101000100110000
0010010110100101000110101
0001011011000000100110011
1000101010110101010101100
0010001111101110001111110
1111111010010110100111110
0100111110010100111110110
0110100110000110110100001
0000101000001001110010110
1010011100000011000010110
10 25
0001110001000000101011011
1111001010011010111101100
1010011011110100110010100
1110000000110100010011101
0100011100001101011111011
0001111010010101101001101
1011010101001111011000001
0100100010010100000000110
1011111011100100110110010
1101000001001001101111100
10 25
0101101000111100001010011
1111010111101000000001111
0110001000111010000001100
0010000101111011000001100
0110111100111110101100011
1100101010000101100100011
0011101000111101011010110
0000010001000110101010101
1001110001100110111110000
1110010011010100110001100
10 25
1000011011000100110100101
1011000110100000111110100
1101101101001101010000101
1011010001100011000101010
0110100100110110110010001
0101010011110000111111011
0011010010000011111101110
0011110111000010110010111
1000101001010010001110100
0101101110001111011110110
10 25
0011001010101001110001001
0001001101110010001010010
0100001100001110000111110
1000100000000100111111111
0010001001100100101101110
1111010100100010011001010
1010001101101111010011011
0111011100110001010111101
1011111001001100000101011
0111101110100010101111010
10 25
1101010110000001010111001
0010011101010100010011111
1101100100000011000000001
1111110011000101101111101
0111110111011010110011111
0111101100010100101000111
1110001110010110010101110
0110011001001110100011101
1110101110100111000001110
0100101100001000010011100
10 25
1101101000000101000010011
1001010101011110000001111
1000010011000110011010100
0000001011111111011101011
0000011100101100110110110
0001100000001110011110011
0111100000001000000001010
0010100100100011010000111
0100101110001101100101000
0100110011110100110110101
10 25
1001011011011001010010001
1110100000010110000000110
0100000100000011110000000
1101000101001111101001010
1111000100010011110010110
0011110100101010011010001
0110101111010011011001011
0100000010110011110100011
1011100110100001000011100
1100100010000010110011000
10 25
1100010100010101011000110
1000101101000101010001100
0000010001110001111100111
0001110000110010001011101
0100011110101011110001100
1010000000010101110000110
1011011011111100110010000
1111110110111101100111001
1101101101110101011000100
0110111110111111011111101
10 25
1100110010011111101001010
1000111000001000010100010
0111101011010101111100111
0111010010110000001011111
1001110001100110010000110
1101101010001001001011000
1110000011111100100000111
1101001101100101010011000
0110011110001001010101010
1101000110011011000101111
10 25
0111011110011111100000001
1101111000001110011111011
0110011110001101100110111
1011101011111101010110100
0110001000101000110100011
0011010001110011110100111
1001010000101111000101000
1110101101000001101010011
0110110001100100101100110
1000011010100010001101110
10 25
1101010010011111100101100
1101100100101101110000010
1000111100110110011000000
0111011110000110100110000
0100101111101101000110110
1101001011100100001100001
0011110111011100111110000
1110100101000001011101000
0011100000110001100000001
1101010110110011101011001
10 25
0000111000010111000100000
1111011010111100000111000
1011101011011000101100011
1111101011011011100111100
1011001101000001000100111
0000111100110100100110001
0110001110111110110011110
0000001100001010011101100
1001111011011010001110111
0101111000101010001000010
10 25
0011111101100100110011101
1100101100100111010101100
0011111101011110101011111
0111111100000011100010110
0011110100000101001011101
1110110110000111100011011
1011010011100110110011100
1010110000101001101100101
0010101011011101100000111
1100111100110000001101100
10 25
0110111110011101011101001
0101001011100010101010111
1101000000010110000010010
0010110010001001000111000
1001001111100101100101010
1000010111000100101101000
1101000010000111101010001
1100111111101000101010001
0011111000100011101101011
1000100100011000110000110
10 25
1000101100101110010110100
1100001111010010101110010
0010111011100100001010010
1001100110010110010000101
0101100010101000110111110
1111111111111101100100111
0100111001100110100111110
1100100111100101111111001
0000101111101100010010010
1001111111011100011001101
10 25
1001101001100110000100001
0000100001110010111100101
1110000101111000011000101
1101111110001110000110001
1100001000110101100110111
1000111100000001100010010
0001100111111111100001000
0010100111100010011100000
0010101010100100011101110
1011110100011110110101110
10 25
0001100011011010010001101
1111100001011011100000111
0000000000100110101100010
0111010001011001110001000
1111001001100011011011010
1000101010111011111111100
0111000011110010011110101
1000000110110111000101111
1011100001110001110011110
0100001101111001100001010
10 25
1110111000011010101111100
0101010100111111010011011
0101110000010111011011001
1001111101000111010000110
0100110110110011010101001
0110101000111011101010011
1111000010001110111111001
0001110010011110111111000
1000111110000001101101111
1000000100010011100101000
10 25
1101111011100010001111010
0110100011101000111101101
1001010000111000010000001
0100011011010001010010011
1011111011101111001010000
1000010001011101001010111
0101000010010000111101010
0100110000111011110100110
1011101011111011011011111
0101111100011001000000000
10 25
0101101100010100100100010
1001111010101110100111010
1000111100101001011010110
1010111011011100001110001
0110010010101101100010110
0010010000100100101010100
1001000001000010000011111
0111110010011110001100001
1100000001011101001011100
1010001101101100111000010
10 25
1001111010010101000001000
1010101100001110011100100
1101101000100010101110011
0010111000011110111011110
0101100110010001011011011
1100000101100010101000100
0000000001100011100101101
1111011111100111110011010
0111111111000111100110010
1111001011001011011100001
10 25
0001111111001101101101011
1110110110111111110100110
0010101110000010100101111
1101101111001100011010100
1101000000011011110010011
1100001001111000011010111
0110101001100001000001011
1111000010100101011111100
0101001100111110011000010
0100101101100001001111011
10 25
1001111110101110111011111
0001110000001010001001111
0100111010101101101110110
0100100101001010101101111
0010001111010001001000101
0101100100101001000101101
1111010100011001110000011
1000011100011001101011011
0101100000111111001010111
0000100100111001101110010
10 25
1101000001100101110100000
1000010011010111111001010
0011101000000010011111101
0001010001111111111100011
0101110000111101000001001
0001011010001101110110000
1000001001001001111000110
0110111000111010010111011
0000000100011000001110111
0111000111000100110111111
10 25
0001100011110011010000111
1011000100111001110111110
0010010101011110010110000
0110010011001010001100101
1011010000011101001001010
1110001001010010111111111
0001110111000100011100111
0111111010010100011101010
1100100110110010101011001
1010000101101101110010110
10 25
0000000000000000000000000
0000000000000000000000000
0000000000000000000000000
0000000000000000000000000
0000000000000000000000000
0000000000000000000000000
0000000000000000000000000
0000000000000000000000000
0000000000000000000000000
0000000000000000000000000
10 25
1111111111111111111111111
1111111111111111111111111
1111111111111111111111111
1111111111111111111111111
1111111111111111111111111
1111111111111111111111111
1111111111111111111111111
1111111111111111111111111
1111111111111111111111111
1111111111111111111111111
