30
4 25
1111111100111110000001000
1010011111111000010110010
1001000010000011000010001
1010101001101110101010110
4 25
1111110010110111001111101
1100111000010010011100001
0010101011001011011110001
1111000000111110110011111
4 25
0011101101101101111011101
0101011101100101110110001
1101110100110011110011110
0111100010010101101100000
4 25
1011011110110001010001110
0110011010001111001000001
1010000110011010001010000
0010000111110110011011001
4 25
1011001001100111011011111
1011100100010111110100011
1101111000111001100010000
0001101100010100100111001
4 25
1111100001110011110111000
1111011010000100010001001
1110101010001001000111011
1100011001100010110100011
4 25
0000101001001001110110100
1001100000001111111000100
1111100001100011110010010
0100101101001010110010111
4 25
1111110111101010100001101
0110100100011100110110110
1010101001110111111111010
0100001011001001010011111
4 25
1100101100101010111101001
1111101001011001001011111
1011111001111101111010000
1000001101001111110000000
4 25
1110111000001110110000000
0001100001111001111011101
1100001111101000100101100
1100001110110000010000100
4 25
1101100010110011001100110
0100011100000000100101000
0100100011001000110110001
0000011100100010101110101
4 25
0001110010110010100001111
0110000110100101001110001
0111110011100101000111110
1101110010100011001110100
4 25
1001010011111010001111011
0001000011000010001101100
1010001111100000001111010
0110010100000101001011001
4 25
1111011010001010011100110
1100000001001100000011010
1011101110000010000001101
0001011100000110000110110
4 25
0010011001111110001100011
1011101011101000100011010
0100100001100000000101110
1000100000010100110011010
4 25
1101101110110100000010001
0010111110010110101001011
0100011101011010110101011
1101110000100011111101000
4 25
0100101110010001000000000
0100110001000110011011000
1111000111100101011110011
0101010001000001111101111
4 25
1110101001000101101101010
1010101010111010011000110
0000010001011100111001001
0101101001111101100111100
4 25
1100101010101111100000001
1010100001101000000111111
0111111100111010100100010
1110100101100100100000001
4 25
0011010100100101010011100
1100100000000011100101001
1000000100100100011101100
0010101100011110001000001
4 25
0100001010110001111110101
0101111111000101011101001
0101010101111111110100100
0101100011111010110111011
4 25
1000001010100000011110110
0100110101011110000111001
1110111001011001010110111
0001111100001000111110100
4 25
1101110000111110100000011
1111101110111111001000101
1110000111110110011010011
1000011111111001000110000
4 25
0010111101111001010011111
0001010011110011000110100
1110011101101000100011010
0101000110101001101101100
4 25
0000111101101101001010110
1111001001001010111010011
0010011000100110111111100
0011001110000100111101010
4 25
0000100110100010010001001
1111101101011100100011011
1010110101011110110010111
1100110001101011001010110
4 25
0011001111000001011010110
0101111010111111001110101
0000100001101111001100111
1011101101001110010010111
4 25
1000010000101111010101110
1001010011100000101000110
0010100111000110110000001
0001010001110110100100001
4 25
0000000000000000000000000
0000000000000000000000000
0000000000000000000000000
0000000000000000000000000
4 25
1111111111111111111111111
1111111111111111111111111
1111111111111111111111111
1111111111111111111111111
