30
1 25
0010011111100010000010011
1 25
0101111101110111110001101
1 25
1101011011000010100101110
1 25
0011001001010111001111000
1 25
0010000111100100111101111
1 25
1110101011000010111111010
1 25
1111001001101110110001101
1 25
0111000001110001010111011
1 25
1000001110011101101000011
1 25
1010010110110001011100010
1 25
1011110010101111100011100
1 25
1010101110001100100101001
1 25
0010011110110110011000100
1 25
0111100011100101000000100
1 25
0000110000101010011110101
1 25
1101111100010011001100110
1 25
1111011111011011100010010
1 25
1100011001111000100110011
1 25
1000111101010000111110111
1 25
0110101000010011100001000
1 25
1000111010000001010100111
1 25
0110100010011001001100111
1 25
0110101001111001100000011
1 25
0010010001100100110100100
1 25
0001111010110000101101010
1 25
0101011111100011110011101
1 25
1001101000100110101010000
1 25
0101010111000011110111010
1 25
0000000000000000000000000
1 25
1111111111111111111111111
